X;X;X;X;X;X;X;X;X;X;X;X;X;X;X;X;X;X;X;X;X;X;X;X;X;X;X;X;X;X;X;X;X;X;X;X;X;X;X;X;X;X;X;X;X;X;X;X;X;X;X;X;X;X;X;X;X;X;X;X;X;X;X;X;X;X;X;X;X;X;X;X;X;X;X;X;X;X;X;X;X;X;X;X;X;X;X;X;X;X;X;X;X;X;X;X;X;X;X
X;X;X;X;X;X;X;X;X;X;X;X;X;X;X;X;X;X;X;X;X;X;X;X;X;X;X;X;X;X;X;X;X;X;X;X;X;X;X;X;X;X;X;X;X;X;X;;;;;;;;;;;;;;;;;;;;;;;;;;;;X;X;X;X;X;X;X;X;X;X;X;X;X;X;;;;X;X;X;X;X;X;X;X
X;X;X;X;X;X;X;X;X;X;X;X;X;X;;;;;X;X;X;X;X;X;X;X;X;X;X;X;X;X;X;X;X;;;;;;;X;X;X;X;X;X;;;;;;;;;;;;;;;;;;;;;;;;;;;X;X;X;X;X;;;;X;X;X;X;X;;;;;;;X;X;X;X;X;X;X
X;X;X;X;X;X;X;X;X;;;B37;;;;;;;;;;X;X;X;X;X;X;X;X;X;X;X;;;;;;;;;;;;X;X;X;X;;;;;X;X;X;;;;;;;;;;;;;;;;;;;;X;X;X;X;X;;;;;X;X;X;;;;;;;;X;X;X;X;X;X;X
X;X;X;X;X;X;X;;;;;;;;;;;;;;;;;X;X;X;X;X;X;X;;;;;;;;;;;;;;B33;;;;;;;X;X;X;X;X;;;;;;;;;;;X;X;X;;;;;;X;X;X;X;X;;;;;;;;;;;;;;;X;X;X;X;X;X;X
X;X;X;X;;;;;;;;;;;;;;;;;;;;X;X;X;X;X;X;X;;;;;;;;;;;;;;;;;;;;;X;X;X;X;X;;;;;;;;;;X;X;X;X;X;;;;;;X;X;X;;;;;;;;;;;;;;;;X;X;X;X;X;X;X
X;X;X;;;;;;;;;;;;;;;;;;;;;;X;X;X;X;X;;;;;;;;;;;;;;;;;;;;;;X;X;X;X;X;;;;;X;;;;;X;X;X;X;X;;;;;;;;;;;;;;;;;;;;;;;;X;X;X;X;X;X;X
X;X;X;;;;;;;;;;;;;;;;;;;;;;X;X;X;X;X;;;;;;;;;;;;;;;X;X;X;;;;;;X;X;X;;;;;;;X;;;;X;X;X;X;X;;;;;;;;;;;;;;;;;;;;;;;;X;X;X;X;X;X;X
X;X;X;;;;;;;;;;;;;;;;;;;;;;;X;X;X;;;;;;;;;;;;;X;X;X;X;X;X;;;;;;;;;;;;;;;X;X;;;;X;X;X;;;;;;;A33;;;;;;;;X;X;X;;;;;;;;X;X;X;X;X;X;X
X;X;X;;;;;;;;;X;X;X;X;;;;;;;;;;;X;X;X;;;;;;;;;;;;X;X;X;X;X;X;X;A33;;;;;;;;;;;;;;;;;;;;X;;;;;;;;;;;;;;;X;X;X;X;X;;;;;;;X;X;X;X;X;X;X
X;X;X;;;;;;;;X;X;X;X;X;X;X;;;;;;;;;;X;;;;;;;;;;;X;X;X;X;X;X;X;X;X;;;;;;;;;;;;;;;;;;;;X;X;X;;;;;;;;;;;;;;X;X;X;X;X;;;;;;;X;X;X;X;X;X;X
X;X;X;;;;;;;X;X;X;X;X;X;X;X;X;;;;;;;;;;;;;;;;;;X;X;X;X;X;X;X;X;X;X;X;X;;;;;;;;;;X;X;X;;;;;;X;X;X;X;X;;;;;;;;;;;;;X;X;X;X;X;;;;;;;X;X;X;X;X;X;X
X;X;X;;;;;;X;X;X;X;X;X;X;X;X;X;;;;;;;;;;;;;;;;;;X;X;X;X;X;X;X;X;X;X;X;X;X;;;;;;;;X;X;X;X;X;;;;;X;X;X;X;X;;;;;;X;X;X;;;;;;X;X;X;;;;;;;;;X;X;X;X;X;X
X;X;X;;;;;;X;X;X;X;X;X;X;X;X;X;;;;;;;;;;;;;;;;;;X;X;X;X;X;X;X;X;X;X;X;X;X;;;;;;;;X;X;X;X;X;;;;;X;X;X;X;X;;;;;X;X;X;X;X;;;;;;;;;;;;;;;;X;X;X;X;X;X
X;X;X;;;;;;X;X;X;X;X;X;X;X;X;X;;;;;;;;;;;;;;;;;;X;X;X;X;X;X;X;X;X;X;X;X;X;X;;;;;;;X;X;X;X;X;;;;;;X;X;X;;;;;;X;X;X;X;X;;;;;;;;;;;;;;;;;X;X;X;X;X
X;X;X;;;;;;;X;X;X;X;X;X;X;X;X;X;X;;;;;;;;;;;;;;;;X;X;X;X;X;X;X;X;X;X;X;X;X;X;X;;;;;;;X;X;X;;;;;;;;;;;;;;;X;X;X;X;X;;;;;;;;;;;;;;;;;;X;X;X;X
X;X;X;;;;;;;;X;X;X;X;X;X;X;X;;;;;;;;;;;;;;;;X;X;X;X;X;X;X;X;X;X;X;X;X;X;X;X;X;;;;;;;;;;;;;;;;;;;;;;;;;X;X;X;;;X;X;X;;;;;;;;;;;;;;X;X;X;X
X;X;X;X;;;;;;;;X;X;X;X;X;X;X;;;;;;;;;X;;;;;;;;;X;X;X;X;X;X;X;X;X;X;X;X;X;X;X;X;X;;;;;;;;;;;;;;;;;;;;;;;;;;;X;X;X;X;X;;;;;;;;;;;;;X;X;X;X
X;X;X;X;;;;;;;;X;X;X;X;X;X;X;;;;;;;;X;X;X;;;;;;;;X;X;X;X;X;X;X;X;X;X;X;X;X;X;X;X;X;X;X;X;X;X;X;X;;;;;;;;;;;;;;;;;;;;X;X;X;X;X;;;;;;;;;;;;;X;X;X;X
X;X;X;X;X;;;;;;;X;X;X;X;X;X;X;;;;;;;X;X;X;X;X;;;;;;;X;X;X;X;X;X;X;X;X;X;X;X;X;X;X;X;X;X;X;X;X;X;X;X;X;X;X;X;;;;;;;;;;;;;;;;X;X;X;X;X;;;;;;;;;;B33;;;;X;X;X
X;X;X;X;X;;;;;;;X;X;X;X;X;X;X;;;;;;;;X;X;X;;;;;;;;X;X;X;X;X;X;X;X;X;X;X;X;X;X;X;X;X;X;X;X;X;X;X;X;X;X;X;X;X;X;;;;;;;;;;;;;;;X;X;X;;;;;;;;;;;;;;;X;X;X
X;X;X;X;X;X;;;;;;X;X;X;X;X;X;X;X;;;;;;;;;;;;;;;;X;X;X;X;X;X;X;X;X;X;X;X;X;X;X;X;X;X;X;X;X;X;X;X;X;X;X;X;X;X;X;X;;;;;;;;;;;X;X;X;X;X;X;X;X;X;;;;;;;;;;;;X;X;X
X;X;X;X;X;X;;;;;;X;X;X;X;X;X;X;;;;;;;;;;;;;;;;;X;X;X;X;X;X;X;X;X;X;X;X;X;X;X;X;X;X;X;X;X;X;X;X;X;X;X;X;X;X;X;X;X;X;X;X;X;X;X;X;X;X;X;X;X;X;X;X;X;X;X;X;;;;;;;;;;X;X;X;X
X;X;X;X;X;X;X;;;;;X;X;X;X;X;X;X;;;;;;;;;;;;;;;;;X;X;X;X;X;X;X;X;X;X;X;X;X;X;X;X;X;X;X;X;X;X;X;X;X;X;X;X;X;X;X;X;X;X;X;X;X;X;X;X;X;X;X;X;X;X;X;X;X;X;X;X;X;;;;;;;;X;X;X;X;X
X;X;X;X;X;X;X;;;;;X;X;X;X;X;X;X;X;;;;;;;;;;;;;;;;X;X;X;X;X;X;X;X;X;X;X;X;X;X;X;;;;;;;;;;X;;;;;;X;X;X;X;X;X;X;X;X;X;X;X;X;X;X;X;X;X;X;X;X;X;X;;;;;;;;X;X;X;X;X
X;X;X;X;X;X;X;X;;;;X;X;X;X;X;X;X;X;X;X;X;;;;;;;;;;X;X;;X;X;X;X;X;X;X;X;X;X;X;X;X;X;X;;;;;;;;;;;;;;;;;;;X;X;X;X;X;X;X;X;X;X;X;X;X;X;X;X;X;X;X;;;;;;;;X;X;X;X;X;X
X;X;X;X;X;X;X;X;;;;X;X;X;X;X;X;X;X;X;X;X;X;X;;;;;;X;X;X;X;X;X;X;X;X;X;X;X;X;X;X;X;X;X;X;;;;;X;X;;;;;;;;;;;;;;;;;;X;X;X;X;X;X;X;X;X;X;X;X;X;X;;;;;;;;;X;X;X;X;X;X
X;X;X;X;X;X;X;;;;;X;X;X;X;X;X;X;X;X;X;X;X;X;X;A33;;;X;X;X;X;X;X;X;X;X;X;X;X;X;X;X;X;X;X;X;X;;;;X;X;X;X;X;X;;;;;;;;;;;;;;;;;X;X;X;;;X;X;X;X;X;X;;;;;;;;;X;X;X;X;X;X;X
X;X;X;X;X;X;X;;;;X;X;X;X;X;X;X;X;X;X;X;X;X;X;X;;;;X;X;X;X;X;X;X;X;X;X;X;X;X;X;X;X;X;X;X;;;;;X;X;X;X;X;X;;X;X;X;;;;;;;;;;;;;;;;;;;X;X;;;X;;;;;;X;X;X;X;X;X;X;X;X;X
X;X;X;X;X;X;;;;;X;X;X;X;X;X;X;X;X;X;X;X;X;X;X;;;;X;X;X;X;X;X;X;X;X;X;X;X;X;X;X;X;X;X;X;;;;;;X;X;X;X;X;;X;X;X;X;;;;;;;;X;X;;;;;;;;;;;;;X;;;;;;X;X;X;X;X;X;X;X;X;X
X;X;X;X;X;X;;;;X;X;X;X;X;X;X;X;X;X;X;X;X;X;X;;;;;;X;X;X;X;X;X;X;X;X;X;X;X;X;X;X;X;X;X;;;;;;;;X;X;X;;X;X;X;X;;;;;;;X;X;X;X;X;;;;;;;;;;;X;;;;;;;;;X;X;X;X;X;X;X
X;X;X;X;X;;;;;X;;;;;;;;X;X;X;X;X;X;;;;X;;;;X;X;X;X;X;X;X;X;X;X;X;X;X;X;X;X;X;X;;;;;;;;X;X;;X;X;X;X;;;;;;;X;X;X;X;X;X;;;;;;;A33;;;X;;;;;;;;;;;;X;X;X;X
X;X;X;X;X;;;;X;;;;;;;;;X;X;X;X;X;X;;;;X;;;;X;X;X;X;X;X;X;X;X;X;X;X;X;X;X;X;X;X;;;;;;;X;X;X;;X;X;X;X;X;X;;;;;;X;X;X;X;X;;;;;;;;;;X;;;;;;;;;;;;;;;X
X;X;X;X;;;;;X;;;X;;;;;;;X;X;X;X;X;;;;;;;;X;X;X;X;X;X;X;X;X;X;X;X;X;X;X;X;X;X;;;;;;;X;X;X;;X;X;X;X;X;X;X;;;;;X;X;X;X;;;;;;;;;;;X;;;;;;;;;;;;;;;X
X;X;X;X;;;;;X;;;;X;;;;;;;X;X;X;X;X;;;;;;X;X;X;X;X;X;X;X;X;X;X;X;X;X;X;X;X;X;X;;;;;;;X;X;X;A33;;;X;X;X;X;X;;;;;;X;X;;;;;;;;;;;;X;;;;;;;;;;;;;;;X
X;X;X;;;;;;X;;;;;X;X;;;;;;X;X;X;X;X;;;;X;X;X;X;X;X;X;X;X;X;X;X;X;X;X;X;X;X;X;X;X;;;;;X;X;X;X;;;;X;X;X;X;X;X;;;;;;;;;;;;;;;;;;X;X;X;X;;;;;;;;;;;;X
X;X;X;;;;;;X;;;;;X;X;X;;;;;X;X;X;X;X;X;S;X;X;X;X;X;X;X;X;X;X;X;X;X;X;X;X;X;X;X;X;X;X;;;;;X;X;X;X;;;;X;X;X;X;X;X;;;;;;;;;;X;X;X;X;;;X;X;X;X;X;X;X;X;;;;;;;;;;X
X;X;X;;;;;;X;X;;;X;X;X;X;X;;;;X;X;X;X;X;X;X;X;X;X;X;X;X;X;X;X;X;X;X;X;X;X;X;X;X;X;X;X;X;;;;;;X;X;X;X;X;;X;X;X;X;X;;;;;;;;;;X;X;X;X;X;X;X;X;X;X;X;X;X;X;X;X;;;;;;;;;X
X;X;X;;;;;;X;;;;X;X;X;X;X;;;;X;X;X;X;X;X;X;X;X;X;X;X;X;X;X;X;X;X;X;X;X;X;X;X;X;X;X;X;;;;;;;X;X;X;X;X;;X;X;X;X;X;;;;;;;;;;X;X;X;X;X;X;X;X;X;X;X;X;X;X;X;X;X;;;;;;;;X
X;X;X;;;X;;;X;;;;;X;X;X;;;;;X;X;X;X;X;X;X;X;X;X;X;X;X;X;X;X;X;X;X;X;X;X;X;X;X;X;X;;;;;;;;X;X;X;X;X;;X;X;X;X;X;X;;;;;;;;;X;X;X;X;X;X;X;X;X;X;X;X;X;X;X;X;X;;;;;;;;X
X;X;X;;;X;;;X;;;;;;X;;;;;;X;X;X;X;;;;;;X;;;;;;;;;;X;;;;;;X;;;;;;;;;;X;X;X;X;;X;X;X;X;X;X;;;;;;;;;;X;X;X;X;X;X;X;X;X;X;X;X;X;X;X;X;;;;;;;;X
X;X;X;;;;X;;X;X;;;;;X;;;;;X;X;X;X;X;;;X;;;X;;;;;;;;;;;;;X;;;X;;;;;;;;;;;X;X;X;;X;X;X;X;X;X;;;;;;X;;;;X;X;X;X;X;X;X;X;X;X;;;;X;X;B33;;;;;;;;X
X;X;X;;;;X;;X;X;;;;;X;;;;X;X;X;X;X;;;;X;;X;X;;;;;;X;X;;;;;;X;;X;X;;;;;X;;;;;;X;X;X;;X;X;X;X;X;X;;;;;X;;;;;X;X;X;X;X;X;X;X;X;;;;;;;;;;;;;;;X
X;X;X;X;;;;;X;X;X;;;;X;;;X;X;X;X;X;X;;;;X;;;;;;;;X;X;X;X;B33;;;X;X;;;;;;;X;X;X;;;;;X;X;X;;X;X;X;X;X;;;;;X;X;;;;;X;;;X;X;X;;;;;;;;;;;;;;;X;X;;X
X;X;X;;;;X;X;X;X;X;;;;X;;;;;X;X;X;;;;;X;X;;;;;;;X;X;X;X;;;;X;X;X;;;;;;;X;;;;;;X;X;X;;X;X;X;X;X;;;;;X;;;;;;X;;;;;;;;;;;;;;;;;;X;X;X;;;X
X;X;X;A33;;;;;;;;;;;X;;;;;X;X;;;;;;X;;;;;;;;X;X;X;X;;;;X;X;;;;;;;;X;;;;;;;X;X;;X;X;X;X;;;;;;;;;;;;X;;;;;;;;;;;;;;;;;;X;X;X;;;X
X;X;X;;;;;;;;;;;;X;A33;;;;;;;;;;;X;;X;X;;;;;;X;X;;;;;;X;;X;X;;;;;X;;;;;;;;;;X;X;;;;;;;;;;;;;;X;;;;;;;X;;;;;;;;;;;;X;;;;X
X;X;X;;;;;;;;;;;;X;;;;;;;;;;;;X;;;X;;;;;;;;;;;;;X;;;X;;;;;;;;;;;;;;;;;;;;;;;;;;;;;;;;;;;;;X;;;;;;;;;;;;;;;;X
X;X;X;;;;;;X;;;;;;X;;;;;;;;X;;;;;;;X;;;;;;;;;;;X;;;;;X;;;;;;;;;;;;;X;;;;;;;;;;;;;;;;;;;;;;;;X;;;;;;;;;;;;;;;;X
X;X;X;X;X;X;X;X;X;X;X;X;X;X;X;X;X;X;X;X;X;X;X;X;X;X;X;X;X;X;X;X;X;X;X;X;X;X;X;X;X;X;X;X;X;X;X;X;X;X;X;X;X;X;X;X;X;X;X;X;X;X;X;X;X;X;X;X;X;X;X;X;X;X;X;X;X;X;X;X;X;X;X;X;X;X;X;X;X;X;X;X;X;X;X;X;X;X;X
