X;X;X;X;X;X;X;X;X;X;X;X;X;X;X;X;X;X;X;X;X;X;X;X;X;X;X;X;X;X;X;X;X;X;X;X;X;X;X;X;X;X;X;X;X;X;X;X;X;X;X;X;X;X;X;X;X;X;X;X;X;X;X;X;X;X;X;X;X;X;X;X;X;X;X;X;X;X;X;X;X;X;X;X;X;X;X;X;X;X;X;X;X;X;X;X;X;X;X;X;X;X;X;X;X;X;X;X;X;X;X;X;X;X;X;X;X
X;A51;;;;;;;;;;;;;;;I;O;;;;;;;;;;;;;;;;;;;;;;;;;;;;;;X;X;X;X;X;X;X;X;X;X;X;X;X;X;X;X;X;X;X;X;X;;;;;;;;;;;;;;;;;;;;;;;;;;;;;;;;;;;;;;;;;;;;;;;;;X
X;;;;;X;X;X;X;X;X;X;X;X;X;X;X;;;;;;;;;;;;;;;;;;;;;;;;;;;;;;;;X;X;X;X;X;X;X;X;X;X;X;X;X;X;X;X;X;X;X;;;;;;;;;;;;;;;;;;;;;;;;;;;;;;;;;;;;;;;;;;;;;;A33;;;;X
X;;;;;;;;X;X;X;X;X;X;X;X;X;X;X;X;X;;;;;;;;;;;;;;;;;;;;;;;;;;;;;;X;X;X;X;X;X;X;X;X;X;X;X;X;X;X;;;;;;;;;;;;;;O;O;;;;;;;;;;;;;;;;;;;;;;;;;;;;;;;;;;;;;X
X;X;X;X;X;X;X;;X;X;X;X;X;X;X;X;X;X;X;X;X;X;X;X;X;;;;;;;;;;;;;;;;;;;X;X;;;;;;;;X;X;X;X;X;X;X;X;X;X;X;X;;;;;;;;;;;;;;X;I;I;X;;;;;;;;;;;;;X;X;X;X;;;;X;X;X;X;;;X;;;;X;;;;;;X
X;;;;;;;;;;;;;;;;X;X;X;X;X;X;X;X;;;;;;;;;;;;;;;;;;;;X;X;;;;;;;;;;X;X;X;X;X;X;X;X;X;;;;;;;;;;;;;X;X;X;;;X;X;X;;;;;;;;;;;X;;;X;;;;X;;;X;;;X;;;X;;;;;;;X
X;X;X;X;X;X;X;X;X;X;X;X;X;;X;X;X;X;X;X;X;X;;;;;;;;;;;;;;;;;;;;;;;;X;X;;;;;;;;X;X;X;X;X;X;X;X;X;;;;;;;;;;;;X;X;X;X;;;X;X;X;X;;;;;;;;;;X;;;X;;;;X;;;X;;;X;;X;;;;;X;;;X
X;;;;;;;;;;;;;;;;X;X;X;X;X;X;;;;;;;;;;;;;;;;;;;;;;;;X;X;;;;;;;;;X;X;X;X;X;X;X;;;;;;;;;;;X;X;X;X;X;X;;;X;X;X;X;X;;;;;;;;;X;X;X;X;;;;X;X;X;X;;;X;X;;;;;;X;;;X
X;X;X;X;X;X;;X;X;X;X;X;X;X;X;X;X;X;X;X;X;X;X;;;;;;;;;;;;;;;;;;;;;;;;;X;;;;;;;;X;X;X;X;X;X;X;;;;;;;;;;;X;X;X;X;X;X;;;X;X;X;X;;;;;;;;;;X;X;X;X;X;;;X;A33;;X;;;X;;;;;;;X;;;X
X;;;;;;;;;;;;;;;;X;X;X;X;X;X;X;X;;;;;;;;;;;;;;;;;;;;;;;;;;;;;;;;;X;X;X;X;;;;;;;;;;;;X;X;X;X;X;X;X;;;X;X;X;X;X;X;;;;;;;;X;;;;X;;;X;;;X;;;X;X;;;;;;X;;;X
X;;X;X;X;X;X;X;X;X;X;X;X;X;X;X;X;X;X;X;X;X;X;X;X;;;;;;;;;;;;;;;;;;;;;;;;;;;;;;;;X;X;X;X;X;;;;;;;;;X;X;X;X;X;X;X;X;X;;;X;X;X;X;X;X;X;X;;;;;;X;;;;X;;;X;;;X;;;X;;X;;;;;X;;;X
X;;;;;;;;;;;;;;;;X;X;X;X;X;X;X;X;;;;;;;;;;;;;;;;;;;;;;;;;;;;;;;;;;X;X;X;;;;;;;;;X;X;X;X;X;X;X;X;X;X;;;X;X;X;X;X;X;X;X;X;;;;;X;;;;X;;;X;;;X;;;X;;;X;;;;X;;;X
X;X;X;X;X;X;X;X;X;;X;X;X;X;X;X;X;X;X;X;X;X;;;;;;;;;;;;;;;;;;;;;;;;;;;;;;;;;;;;;X;;;;;;;;;X;X;X;X;X;X;X;X;X;X;X;;;X;X;X;X;X;X;X;X;X;X;X;;;X;X;X;X;X;;;X;;;X;;;X;;;;X;;;X;;;X
X;;;;;;;;;;;;;;;;X;X;;;;;;;;;;;;;;;;;;;;;;;;;;;;;;;;;;;;;;;;A35;;;;;;;;;X;X;X;X;X;X;X;X;X;X;X;X;;;X;X;X;X;X;X;X;X;X;X;X;X;;;;;;;;;;;;;;;;;;;;;;;;;X
X;X;X;;X;X;X;X;X;X;X;X;X;X;X;X;X;A11;;;;;;;;;X;X;;;;;;;;;;;;;;;;;;;;;;;;;;;;;;;;;;;;;;;X;;;;;;;;;;;;;;;;;;;;;;;;X;X;;;;;;;;;;;;;;;;;;;;;;;;;X
X;;;;;;;;;;;;I;I;I;;X;X;X;X;X;X;X;X;X;X;X;X;X;X;X;X;;;;;;;X;X;;;;;;;;;;;;;;;;;;;;;;;;;;;X;;;X;X;X;X;X;X;X;X;X;X;X;X;X;X;X;X;;;X;X;X;X;X;;;;X;;;;;;;;;;;;;;;;;;;;;X
X;X;X;X;X;X;X;X;X;X;X;X;A31;;;X;X;X;X;X;X;X;X;X;X;X;X;X;X;X;X;X;X;X;X;X;X;;X;X;;;;;;;;;;;;;;;;;;;;;;;;;;X;X;;;X;X;X;X;X;X;X;X;X;X;X;X;X;X;X;X;;;X;X;X;X;X;X;;X;X;X;;;X;X;X;;;;;X;;;;X;;;;;;X
X;X;X;X;X;X;X;X;X;X;X;;O;O;O;;X;X;X;X;X;X;X;X;X;X;X;X;X;X;X;X;X;X;X;X;X;X;X;X;X;X;;;;;;;;;;;;;;;;;;;;;;;;X;X;;;X;X;X;X;X;X;X;X;X;X;X;X;X;X;X;X;;;X;X;X;X;X;X;X;X;X;X;;X;X;X;X;X;X;X;X;X;X;;X;X;X;;;O;;X
X;X;X;X;X;X;X;X;X;X;X;;;;;;X;X;X;X;X;X;X;X;X;X;X;X;X;X;X;X;X;X;X;X;X;X;X;X;X;X;X;X;X;X;X;X;X;X;X;X;X;X;X;X;X;X;X;X;X;X;X;X;X;X;X;X;X;X;X;X;X;X;X;X;X;X;X;X;X;X;X;X;X;X;X;X;X;X;X;X;X;X;X;X;X;X;X;X;X;X;X;X;X;X;X;X;X;X;X;X;X;X;X;X;X
X;X;X;X;X;X;X;X;X;X;X;;;;;;X;X;X;X;X;X;X;X;X;X;X;X;X;X;X;X;X;X;X;X;X;X;X;X;X;X;X;X;X;X;X;X;X;X;X;X;X;X;X;X;X;X;X;X;X;X;X;X;X;X;X;X;X;X;X;X;X;X;X;X;X;X;X;X;X;X;X;X;X;X;X;X;X;X;X;X;X;X;X;X;X;X;X;X;X;X;X;X;X;X;X;X;X;X;X;X;X;X;X;X;X
X;X;X;X;X;X;X;X;X;X;X;;;;;;X;X;X;X;X;X;X;X;X;X;X;X;X;X;X;X;X;X;X;X;X;X;X;X;X;X;X;X;X;X;X;X;X;X;X;X;X;X;X;X;X;X;X;X;X;X;X;X;X;X;X;X;X;X;X;X;X;X;X;X;X;X;X;X;X;X;X;X;X;X;X;X;X;X;X;X;X;X;X;X;X;X;X;X;X;X;X;X;X;X;X;X;X;X;X;X;X;X;X;X;X
X;X;X;X;X;X;X;X;X;X;X;;;;;;X;X;X;X;X;X;X;X;X;X;X;X;X;X;X;X;X;X;X;X;X;X;X;X;X;X;X;X;X;X;X;X;X;X;X;X;X;X;X;X;X;X;X;X;X;X;X;X;X;X;X;X;X;X;X;X;X;X;X;X;X;X;X;X;X;X;X;X;X;X;X;X;X;X;X;X;X;X;X;X;X;X;X;X;X;X;X;O;O;O;X;X;X;X;X;X;X;X;X;X;X
X;X;X;X;X;X;X;X;X;X;X;;;;;;X;X;X;X;X;X;X;X;X;X;X;X;X;X;X;X;X;X;X;X;X;X;X;X;X;X;X;X;X;X;X;X;X;X;X;X;X;X;X;X;X;X;X;X;X;X;;;;;;;;;;;;;;;;;;;;;;;;;;;;X;X;X;X;X;X;X;X;X;X;X;X;X;X;;;;;;;;;;;;;;X
X;X;X;X;X;X;X;X;X;X;X;;;;;;X;X;X;X;X;X;X;X;X;X;X;X;X;X;X;X;X;X;X;X;X;X;X;X;X;X;X;X;X;X;X;X;X;X;X;X;X;X;X;X;X;X;X;X;X;X;;;;;;;;;;;;;;;;;;;;;;;;;;;X;X;X;X;X;;;;X;X;X;X;X;;;;;;;;;;;;;;;;X
X;X;X;X;X;X;X;X;X;X;X;;;;;;X;X;X;X;X;X;X;X;X;X;X;X;X;X;X;X;X;X;X;X;X;X;X;X;X;X;X;X;X;X;X;X;X;X;X;X;X;X;X;X;X;X;X;X;X;X;;;;;X;X;X;;;;;;A33;;;;;;;;;;;;;;X;X;X;X;X;;;;;X;X;X;;;;;;;;;;;;;;;;;X
X;X;X;X;X;X;X;X;X;X;X;;;;;;X;X;X;X;X;X;X;X;X;X;X;X;X;X;X;X;X;X;X;X;X;X;X;X;X;X;X;X;X;X;X;X;X;;;;;;X;X;;;;;;;;;;X;X;X;X;X;;;;;;;;;;;X;X;X;;;;;;X;X;X;X;X;;;;;;;;;;;;;;;;;;;;;;;;X
X;X;X;X;X;X;X;X;X;X;X;;;;;;X;X;X;X;X;X;X;X;X;X;X;X;X;X;X;X;X;X;X;X;X;X;X;X;X;X;X;X;X;X;X;;;;;A33;;;;;;;;;;;;;;X;X;X;X;X;;;;;;;;;;X;X;X;X;X;;;;;;X;X;X;;;;;;;;;;;;;;;;;;;;;;;;;X
X;X;X;X;X;X;X;X;X;X;;;;;;;;X;X;X;X;X;X;X;X;X;X;X;X;X;X;X;X;X;X;X;X;A33;;;X;X;X;X;X;X;X;;;;;;;;;;;;X;;;;;;;X;X;X;X;X;;;;;X;;;;;X;X;X;X;X;;;;;;;;;;;;;;;;;;;;;;;;;;;;;;;;;X
X;X;X;X;X;X;X;X;X;X;;;;;;;;;X;X;X;X;X;X;X;X;X;X;X;X;X;X;X;X;X;;;;;;X;X;X;X;X;X;X;;;;X;;;X;X;X;X;X;X;X;X;;;;;;X;X;X;;;;;;;X;;;;X;X;X;X;X;;;;;;;;;;;;;;;;;;;;;;;;;;;;;;;;;X
X;X;X;X;X;X;X;X;X;;;;;;;;;;;X;X;X;X;X;X;X;X;X;X;X;X;X;X;;;;;;;;X;X;X;X;X;X;X;;;;X;;;X;X;;;;;X;X;;;;;;;;;;;;;;;X;X;;;;X;X;X;;;;;;;A33;;;;;;;;X;X;X;;;;;;;;;;;;;;;;;X
X;X;X;X;X;X;X;X;X;;;;;X;;;;;;;X;X;X;X;X;X;X;X;X;X;X;;;;;;;;;;X;X;X;X;X;X;X;;;;X;;;;;;;;;;X;A33;;;;;;;;;;;;;;;;;;;;X;;;;;;;;;;;;;;;X;X;X;X;X;;;;;;;;;;;;;;;;X
X;X;X;X;X;X;X;X;;;;;;X;X;;;;;;;X;X;X;X;X;X;X;X;X;;;;;;;;;;;X;X;X;X;X;X;X;;;;X;;;;;;X;X;;;X;;;;;;;;;;;;;;;;;;;;X;X;X;;;;;;;;;;;;;;X;X;X;X;X;;;;;;;;;;;;;;;;X
X;X;X;X;X;X;X;X;;;;;;X;X;;;;;;;;X;X;X;X;X;X;X;X;;;;;;;;;;;X;X;X;X;X;X;X;;;;;X;;;;;X;X;;;X;X;;;;;;;;;;X;X;X;;;;;;X;X;X;X;X;;;;;;;;;;;;;X;X;X;X;X;;;;;;;;;;;;;;;;X
X;X;X;X;X;X;X;;;;;;;;;;;;;;;;;;X;X;X;X;X;;;;;;;;;;;;X;X;X;X;X;X;X;;;;;;X;X;;;;;;;X;X;X;;;;;;;;X;X;X;X;X;;;;;X;X;X;X;X;;;;;;X;X;X;;;;;;X;X;X;;;;;;;;;;;;;;;;;X
X;X;X;X;X;X;X;;;;;;;;;;;;;;;;;;;;X;;;;;;;;;;;;;;X;X;X;X;X;X;X;;;;;;;;X;;;;X;X;X;X;X;;;;;;;;X;X;X;X;X;;;;;X;X;X;X;X;;;;;X;X;X;X;X;;;;;;;;;;;;;;;;;;;;;;;;X
X;X;X;X;X;X;;;;;;;;;;;;;;;;;;;;;;;;;;;;;;;;;;;X;X;X;X;X;X;X;;;X;X;;;;;X;;X;X;X;X;X;X;X;;;;;;;X;X;X;X;X;;;;;;X;X;X;;;;;;X;X;X;X;X;;;;;;;;;;;;;;;;;X;X;X;X;X;X;X;X
X;X;X;X;X;X;X;X;;;;;;;;;;;;;;;;;;;;;;;;;;;;;;;;;X;X;X;X;X;X;X;;X;X;X;X;;;;X;;X;;;;X;X;X;X;;;;;;;X;X;X;;;;;;;;;;;;;;;X;X;X;X;X;;;;;;;;;;;;;;;;;;X;X;X;X;X;X;X
X;X;X;X;X;X;X;X;X;X;;;;;;;;;;;;;;;;;;;;;;;;;;;;;;X;X;X;X;X;X;X;X;;;X;X;X;;;;X;;X;;X;;X;X;X;X;;;;;;;;;;;;;;;;;;;;;;;;;X;X;X;;;X;X;X;;;;;;;;;;;;;;;X;X;X;X;X;X
X;X;X;X;X;X;X;X;X;X;X;X;;;;;;;;;;X;;X;;X;;;;;;;;;;;;;X;X;X;X;X;X;X;X;X;;;;X;;;;;X;;X;;X;;X;X;X;X;X;O;;;;;;;;;;;;;;;;;;;;;;;;;;;X;X;X;X;X;;;;;;;;;;;;;;;X;X;X;X;X
X;X;X;X;X;X;X;X;X;X;X;X;X;X;;;;;;;;;A33;;;;;;;;;;;;;;;;X;X;X;X;X;X;X;X;X;;;;;;;;;X;;X;S;X;;X;X;X;X;X;I;X;X;X;X;X;X;X;;;;;;;;;;;;;;;;;;;;X;X;X;X;X;;;;;;;;;;;;;;;;X;X;X;X
X;X;X;X;X;X;X;X;X;X;X;X;X;X;;;;;;;;;;;;;X;;;;;;;;;;;X;X;X;X;X;X;X;X;X;X;A33;;;;;;;X;X;;X;X;X;;X;X;X;X;X;;X;X;X;X;X;X;X;X;X;X;X;;;;;;;;;;;;;;;;X;X;X;X;X;;;;;;;;;;A33;;;;;;X;X;X;X
X;X;X;X;X;X;X;X;X;X;X;X;;;;;;;;;;X;;;;;;;;;;;;;;;;X;X;X;X;X;X;X;X;X;X;;;;;;;X;X;X;;;;;;X;X;X;X;X;;X;X;X;X;X;X;X;X;X;X;X;X;X;;;;;;;;;;;;;;;X;X;X;;;;;;;;;;;;;;;;;X;X;X;X
X;X;X;X;X;X;X;X;X;X;;;;;;;;;;;;;;;;;X;;;;;;;;;;X;X;X;X;X;X;X;X;X;X;X;;;;;;X;X;X;X;X;X;X;X;X;X;X;X;X;X;;X;X;X;X;X;X;X;X;X;X;X;X;X;X;;;;;;;;;;;X;X;X;X;X;X;X;X;X;;;;;;;;;;;;;;;X;X;X
X;X;X;X;X;X;X;X;;;;;;;;;;;;;;;X;;X;;;;;;;;;;;;X;X;X;X;X;X;X;X;X;X;X;;;;;;;X;X;X;X;X;X;X;X;X;X;X;X;X;;X;X;X;X;X;X;X;X;X;X;X;X;X;X;X;X;X;X;X;X;X;X;X;X;X;X;X;X;X;X;X;X;X;X;;;;;;;;;;;;;;X;X;X
X;X;X;X;X;X;;;;;;;;;;;;;;;;;;;;;;;;;;;;;;X;X;X;X;X;X;X;X;X;X;X;X;X;;;;;;;X;X;X;X;X;X;X;X;X;X;X;X;;;;;;;X;X;X;X;X;X;X;;;;;;;;X;X;X;X;X;X;X;X;X;X;X;X;X;X;X;X;;;;;;;;;;;;;X;X;X
X;X;X;X;;;;;;;;;;;;;;;;;;;;;;;;;;;;;;;;X;X;X;X;X;X;X;X;X;X;X;X;X;;;;;;;;X;X;X;X;X;X;X;X;X;X;X;;X;X;X;;;X;X;X;X;X;X;X;;;X;X;X;;;X;X;X;X;X;X;X;X;X;X;X;X;X;X;X;X;X;;;;;;;;;;;;X;X;X
X;X;;;;;;;;;;X;X;;;;;;;;;;;;;;;;;;;;;;X;X;X;X;X;X;X;X;X;X;X;X;X;X;X;;;;X;;;;X;X;X;X;X;X;X;X;X;X;;X;X;X;;;;;;;;;;;;X;X;X;;;;X;X;X;X;X;X;X;X;X;X;X;X;X;X;X;X;X;;;;;;;;;;;X;X;X
X;X;;;;;;;;;X;X;X;;;;;;;;;;;;;;;;;;;;;;X;X;X;X;X;X;X;X;X;X;X;X;X;X;X;;;;X;;;;X;X;X;X;X;X;X;X;X;X;I;X;X;X;X;X;X;X;X;X;X;X;X;X;X;X;X;X;;;;X;X;X;X;X;X;X;X;X;X;X;X;X;X;X;X;X;;;;;;;;;;;X;X;X
X;;;;;;;;;;;;;;;;;;;;;;;;;;;;;;;;;X;X;X;X;X;X;X;X;X;X;X;X;X;X;X;X;X;;;;;;;;X;X;X;X;X;X;X;X;;O;;X;X;X;X;X;X;X;X;X;X;X;X;X;X;X;X;;;X;X;X;X;X;;;;;;;;;;X;X;X;X;X;;;;;;;;;;X;X;X
X;X;;;;;;;;;;;;;;;;;;;;;;X;X;X;X;X;X;X;X;X;X;X;X;X;X;X;X;X;X;X;X;X;X;X;X;X;X;X;;;;;;;X;X;X;X;X;X;X;X;X;;;;;X;X;X;X;X;X;X;X;X;X;X;X;X;X;;;;X;X;X;X;;;;;;;;;;;;X;X;X;X;;;;;;;;;;X;X;X
X;X;X;;;;;;;;;;;;;;;;;;X;X;X;X;X;X;X;X;X;X;X;X;X;X;X;X;X;X;X;X;X;X;X;X;X;X;X;X;X;X;X;;;;;X;X;X;X;X;X;X;X;X;;;;;;;X;X;X;X;X;X;X;X;X;X;X;X;X;;;X;X;X;X;C33;;;;;;;;;;;;;X;X;X;X;;;;;;;;;X;X;X
X;X;X;;;;;;;;;;;;;;;X;X;X;X;X;X;X;X;X;X;X;X;X;X;X;X;X;X;X;X;X;X;X;X;X;X;X;X;X;X;X;X;X;X;;;;;X;X;;X;X;X;X;X;X;;;;;;;;;X;X;X;X;X;X;X;X;X;X;;;;X;X;X;;;;;;;;;;;;;;;;X;X;X;;;;;;;;;X;X;X
X;X;;;;;;;;;;;;;X;X;X;X;X;X;X;X;X;X;X;X;X;X;X;X;X;X;X;X;X;X;X;X;X;X;X;X;X;X;X;X;X;X;X;X;X;X;;;;;;;;X;X;X;X;;;;;;;;;;;;;X;X;X;X;X;X;X;;;X;X;X;;;;;;;;;;;;;;;;;;X;X;X;;;;X;;;;X;X;X
X;;;;;;;;;;;X;X;X;X;X;X;X;X;X;X;X;X;X;X;X;X;X;X;X;X;X;X;X;X;X;X;X;X;X;X;X;X;X;X;X;X;X;X;X;X;X;;;;;;;;X;X;X;X;;;;;;;;;;;;;;X;X;X;X;X;X;;;X;X;X;;;;;;;;;;;;;;;C33;;;X;X;X;;;;X;;;;X;X;X
X;X;;;;;;;X;X;X;X;X;X;X;X;X;X;X;X;X;X;X;X;X;X;X;X;X;X;X;X;X;X;X;X;X;X;X;X;X;X;X;X;X;X;X;X;X;X;X;X;X;;;;;;;;X;X;;;;;;;;;;;;;;;;X;X;X;X;X;;X;X;X;I;O;;;;;;;;;;;;;;;;;X;X;X;X;;;X;;;;X;X;X
X;X;;;;;;;X;X;X;X;X;X;X;X;X;X;X;X;X;X;X;X;X;X;X;X;X;X;X;X;X;X;X;X;X;X;X;X;X;X;X;X;X;X;X;X;X;X;X;X;X;;;X;X;;;;X;X;;;;;;;;;;;;;;;;;;X;X;X;;;;;I;O;;;;;;;;;;;;;;;;;X;X;X;X;;;;;;;X;X;X
X;X;;;;;;X;X;X;X;X;X;X;X;X;X;X;X;X;X;X;X;X;X;X;X;X;X;X;X;X;X;X;X;X;X;X;X;X;X;X;X;X;X;X;X;X;X;X;X;X;X;X;;;X;;;;;X;;;;;;;;;;;;;;;;;;;;X;X;X;X;X;I;O;;;;;;;;;;;;;;;;;X;X;X;X;;;;;;;X;X;X
X;X;A53;;;;;X;X;X;X;X;X;X;X;X;X;X;X;X;X;X;X;X;X;X;X;X;X;X;X;X;X;X;X;;;;X;X;X;X;X;X;X;X;X;X;X;X;X;X;X;X;;;;;;;;;;;;;;;;;;;;;;;;;;;;;X;X;X;X;X;;;;;;;;;;;;;;;;;;X;X;X;;;;;;;;X;X;X
X;X;;;;;;X;X;X;X;X;X;X;X;X;X;X;X;X;X;X;X;X;X;X;X;X;X;X;X;X;X;X;;;;;;X;X;X;X;X;X;X;X;X;X;X;X;X;X;X;X;;;;A33;;;;;;X;;;X;;;;;;;;;;;;;;;;;X;X;X;;;;;;;C33;;;;;;;;;;;X;X;X;;;;;;;;X;X;X
X;X;;;;;;;X;X;X;X;X;X;X;X;X;X;X;X;X;X;X;X;X;X;X;X;X;X;X;X;X;;;;;A33;;;X;X;X;X;X;X;X;X;X;X;X;X;X;X;X;;;;;;;;;;;X;X;;;;;;;;;;;;;;;;;;;X;X;X;;;;;;;;;;;;;;;;X;X;X;;;;;;;;;X;X;X
X;X;;;;;;;X;X;X;X;X;X;X;X;X;X;X;X;X;X;X;X;X;X;X;X;X;X;X;X;X;;;;;;;;X;X;X;X;X;X;X;X;X;X;X;X;X;X;X;X;;;;;;;;;;X;X;;;;;;;;;;;;;;;;;;;X;X;X;X;;;;;;;;;;;;;;;X;X;X;;;;;;;;;X;X;X
X;X;;;;;;;;X;X;X;X;X;X;X;X;X;X;X;X;X;X;X;X;X;X;X;X;X;X;X;;;;;;;;;X;X;X;X;X;X;X;X;X;X;X;X;X;X;X;X;X;;;;;;;;X;;;X;;;;;;;;A33;;;;;;;;;;;X;X;X;X;;;;;;;;;;;;;;X;X;;;;;;;;;;X;X;X
X;X;;;;;;;;X;X;X;X;X;X;X;X;X;X;X;X;X;X;X;X;X;X;X;X;X;X;X;;;;;;;;;X;X;X;X;X;X;X;X;X;X;X;X;X;X;X;X;X;X;;;;;;;;;;;;;;;;;;;;;;;;;;;;;X;X;X;X;X;;;;;;;;;;X;;;;X;;;;;;;;;X;X;X;X
X;X;X;;;;;;;;X;X;X;X;X;X;X;X;X;X;X;X;X;X;X;X;X;X;X;X;X;;;;;;;;;;X;X;X;X;X;X;X;X;X;X;X;X;X;X;X;X;X;X;X;;;;;;;;;;;;;;;;;;;;;;;;;;;;;X;X;X;X;X;X;X;X;X;X;X;X;X;X;;;;;;;;;;;;;X;X;X;X
X;X;X;;;;;;;;X;X;X;X;X;X;X;X;X;X;X;X;X;X;X;X;X;X;X;X;X;;;;;;;;;;X;X;X;X;X;X;X;X;X;X;X;X;X;X;X;X;X;X;X;X;X;;;;;;;;;;;;;;;;;;;;;;;;;;;X;X;X;X;X;X;X;X;X;X;X;X;X;X;X;;;;;;;;;;;X;X;X;X;X
X;X;X;X;;;;;;;;X;X;X;X;X;X;X;X;X;X;X;X;X;X;X;X;X;X;X;;;;;;;;;;;X;X;X;X;X;X;X;X;X;X;X;X;X;X;X;X;X;X;X;X;X;X;X;X;X;X;X;X;X;X;;;;;;;;;;;;;;;;;;;X;X;X;X;X;X;X;X;X;X;X;X;X;X;X;;;;;;;;;X;X;X;X;X;X
X;X;X;X;;;;;;;;X;X;X;X;X;X;X;X;X;X;X;X;X;X;X;X;X;X;X;;;;;;;;;;;X;X;X;X;X;X;X;X;X;X;X;X;X;X;X;X;X;X;X;X;X;X;X;X;X;X;X;X;X;X;X;;;;;;;;;;;;;;;;;;;X;X;X;X;X;X;X;X;X;X;X;X;X;;;;;;;;;X;X;X;X;X;X;X
X;X;X;X;X;;;;;;;X;X;X;X;X;X;X;X;X;X;X;X;X;X;X;X;X;X;X;;;;;;;;;;;X;X;X;X;X;X;X;X;X;X;X;X;X;X;X;X;X;X;X;X;X;X;X;X;X;X;X;X;X;X;X;X;;;;;;;;;;;;;;;;;;;X;X;X;X;X;X;X;X;X;X;X;;;;;;;;X;X;X;X;X;X;X;X;X
X;X;X;X;X;;;;;;;;X;X;X;X;X;X;X;X;X;X;X;X;X;X;X;X;X;;;;;;;;;;;;X;X;X;X;X;X;X;X;X;X;X;X;X;X;X;X;X;X;X;X;X;X;X;X;X;X;X;X;X;X;X;X;X;;;;;;;;X;;;;;;;;;;;X;X;X;X;X;X;X;X;X;;;;;;;X;X;X;X;X;X;X;X;X;X;X
X;X;X;X;X;;;;;;;;X;X;X;X;X;X;X;X;X;X;X;X;X;X;X;X;X;;;;;;;;;;;;X;X;X;X;X;X;X;X;X;X;X;X;X;X;X;X;X;X;X;X;X;X;X;X;X;X;X;X;X;X;X;X;X;X;;;;;;;X;X;;;;;;;;;;;;;;;;;X;;;;;;;X;X;X;X;X;X;X;X;X;X;X;X
X;X;X;X;X;X;;;;;;;X;X;X;X;X;X;X;X;X;X;X;X;X;X;X;X;X;;;;;;;;;;;;X;X;X;X;X;X;X;X;X;X;X;X;X;X;X;X;X;X;X;X;X;X;X;X;X;X;X;X;X;X;X;X;X;X;;;;;;;X;X;X;X;;;;;;;;;;;;;;;X;;;A33;;;;X;X;X;X;X;X;X;X;X;X;X;X
X;X;X;X;X;X;;;;;;;X;X;X;X;X;X;X;X;X;X;X;X;X;X;X;X;X;X;X;X;X;X;X;;;;;X;X;X;X;X;X;X;X;X;X;X;X;X;X;X;X;X;X;X;X;X;X;X;X;X;X;X;X;X;X;X;X;X;X;;;;;;;;X;X;X;X;X;;;;;;;;;;;;;;;;;;;;X;X;X;X;X;X;X;X;X;X;X;X;X
X;X;X;X;X;X;X;;;;;;;X;X;X;X;X;X;X;X;X;X;X;X;X;X;X;X;X;X;X;X;X;X;;;;;X;X;X;X;X;X;X;X;X;X;X;X;X;X;X;X;X;X;X;X;X;X;X;X;X;X;X;X;X;X;X;X;X;;;;;;;;;X;X;X;X;X;X;;;;;;;X;;;;;;;;;;;;X;X;X;X;X;X;X;X;X;X;X;X;X
X;X;X;X;X;X;;;;;;;A35;;;X;X;X;X;X;X;X;X;X;X;X;;;;;;;;;;;;;;X;X;X;X;X;X;X;X;X;X;X;X;X;X;X;X;X;X;X;X;X;X;X;X;X;X;X;X;X;X;X;X;;;;;;;;;X;X;X;X;X;X;X;X;;;;;;X;;;;;;;;;;;X;X;X;X;X;X;X;X;X;X;X;X;X;X
X;X;X;X;X;;;;;;;;;;;;;;X;X;X;X;X;;;;;;;;;;;;;;;;X;X;X;X;X;X;X;X;X;X;X;X;X;X;X;X;X;X;X;X;X;X;X;X;X;X;X;X;X;X;X;X;X;;;;;;;;X;X;X;X;X;X;X;X;X;X;X;X;X;X;X;X;X;X;X;X;X;X;X;X;X;X;X;X;X;X;X;X;X;X;X;X;X;X;X
X;X;X;X;X;;;;;X;X;;;;;;;;;;X;;;;;;;;;;;;;;;;;;X;X;X;X;X;X;X;X;X;X;X;X;X;X;X;X;X;X;X;X;X;X;X;X;X;X;X;X;X;X;X;X;X;;;;;;;X;X;X;X;X;X;X;X;X;X;X;X;X;X;X;X;X;X;X;X;X;X;X;X;X;X;X;X;X;X;X;X;X;X;X;X;X;X;X;X
X;X;X;X;X;X;;;X;X;X;X;;;;;;;;;;;;;;;;;;X;;;;;;;;X;X;X;X;X;X;X;X;X;X;X;X;X;X;X;X;X;X;X;X;X;X;X;X;X;X;X;X;X;X;X;X;X;X;;;;;;X;X;X;X;X;X;X;X;X;X;X;X;X;X;X;X;X;X;X;X;X;X;X;X;X;X;X;X;X;X;X;X;X;X;X;X;X;X;X;X;X
X;X;X;X;X;X;X;X;X;X;X;X;X;;;;;;;;;;;;;;;;X;X;X;;;;;;X;X;X;X;X;X;X;X;X;X;X;X;X;X;X;X;X;X;X;X;X;X;X;X;X;X;X;X;X;X;X;X;X;X;X;X;X;X;X;X;X;X;X;X;X;X;X;X;X;X;X;X;X;X;X;X;X;X;X;X;X;X;X;X;X;X;X;X;X;X;X;X;X;X;X;X;X;X;X;X;X
X;X;X;X;X;X;X;X;X;X;X;X;X;X;X;X;X;X;X;X;X;X;X;X;X;X;X;X;X;X;X;X;X;X;X;X;X;X;X;X;X;X;X;X;X;X;X;X;X;X;X;X;X;X;X;X;X;X;X;X;X;X;X;X;X;X;X;X;X;X;X;X;X;X;X;X;X;X;X;X;X;X;X;X;X;X;X;X;X;X;X;X;X;X;X;X;X;X;X;X;X;X;X;X;X;X;X;X;X;X;X;X;X;X;X;X;X
